(1)
111111111111111
100000000000001
101110111010111
100010001010001
101011101110111
101000101010101
101010111010101
101010150000001
101111111011111
101010000000001
101011111011111
100000101000001
101011101011111
101000100000000
111111111111111
(2)
111111111111111
100000000000001
101110111011111
101000001010001
101110101011101
101000101000001
101110111110111
100010051000001
101110111010111
100010001010001
101110111010111
100010001010001
101111101110111
100000100010000
111111111111111
(3)
111111111111111
100000100010001
101010101111101
101010000010101
101011111110101
101000101010001
101010101010111
101010050000001
111110101111111
101000100010101
101111101110101
100000000000001
101111111011111
100010000000000
111111111111111
(4)
111111111111111
100010001010101
101010101010101
101010100000001
101111101111111
100000100000101
101111101111101
100010050010101
101010111110101
101000000000001
111010111010111
100010001010001
101011111010101
101000001010100
111111111111111